5 8
.#.#####
A..#...#
#.##.#.#
#.....B#
........